Data Series,Total Live-Births By Ethnic Group (Number),Total Live-Births By Ethnic Group -> Malays (Number),Total Live-Births By Ethnic Group -> Chinese (Number),Total Live-Births By Ethnic Group -> Indians (Number),Total Live-Births By Ethnic Group -> Other Ethnic Groups (Number),Total Male Live-Births By Ethnic Group (Number),Total Male Live-Births By Ethnic Group -> Malays (Number),Total Male Live-Births By Ethnic Group -> Chinese (Number),Total Male Live-Births By Ethnic Group -> Indians (Number),Total Male Live-Births By Ethnic Group -> Other Ethnic Groups (Number),Total Female Live-Births By Ethnic Group (Number),Total Female Live-Births By Ethnic Group -> Malays (Number),Total Female Live-Births By Ethnic Group -> Chinese (Number),Total Female Live-Births By Ethnic Group -> Indians (Number),Total Female Live-Births By Ethnic Group -> Other Ethnic Groups (Number)
  2022 Dec,2887,640,1648,319,280,1465,332,823,161,149,1422,308,825,158,131
  2022 Nov,2943,655,1659,355,274,1491,332,862,173,124,1452,323,797,182,150
  2022 Oct,3109,665,1765,346,333,1603,332,909,185,177,1506,333,856,161,156
  2022 Sep,3272,764,1863,357,288,1733,401,994,194,144,1539,363,869,163,144
  2022 Aug,3005,636,1710,318,341,1547,317,911,168,151,1458,319,799,150,190
  2022 Jul,2962,633,1691,353,285,1536,346,860,180,150,1426,287,831,173,135
  2022 Jun,2844,655,1562,332,295,1465,325,814,177,149,1379,330,748,155,146
  2022 May,2989,681,1714,341,253,1569,361,883,199,126,1420,320,831,142,127
  2022 Apr,2718,656,1490,309,263,1412,325,785,155,147,1306,331,705,154,116
  2022 Mar,3128,717,1734,374,303,1596,369,896,196,135,1532,348,838,178,168
  2022 Feb,2802,640,1567,324,271,1437,328,811,165,133,1365,312,756,159,138
  2022 Jan,3065,654,1761,363,287,1563,330,904,183,146,1502,324,857,180,141
  2021 Dec,3255,684,1845,400,326,1650,356,928,202,164,1605,328,917,198,162
  2021 Nov,3455,686,1998,438,333,1773,369,1011,221,172,1682,317,987,217,161
  2021 Oct,3428,697,1966,435,330,1772,351,1042,206,173,1656,346,924,229,157
  2021 Sep,3381,677,1984,391,329,1752,362,1000,214,176,1629,315,984,177,153
  2021 Aug,3344,672,1873,447,352,1706,317,963,239,187,1638,355,910,208,165
  2021 Jul,3403,693,1958,416,336,1775,357,1011,219,188,1628,336,947,197,148
  2021 Jun,3138,629,1789,386,334,1638,319,930,211,178,1500,310,859,175,156
  2021 May,3214,635,1808,399,372,1639,325,934,208,172,1575,310,874,191,200
  2021 Apr,3105,626,1798,336,345,1590,319,923,178,170,1515,307,875,158,175
  2021 Mar,3329,715,1856,375,383,1724,387,948,193,196,1605,328,908,182,187
  2021 Feb,2632,531,1463,319,319,1347,260,761,163,163,1285,271,702,156,156
  2021 Jan,2988,607,1664,381,336,1568,303,877,202,186,1420,304,787,179,150
  2020 Dec,3138,641,1806,342,349,1630,331,938,173,188,1508,310,868,169,161
  2020 Nov,3176,623,1791,388,374,1648,331,940,196,181,1528,292,851,192,193
  2020 Oct,3494,684,1966,441,403,1764,353,973,229,209,1730,331,993,212,194
  2020 Sep,3355,654,1899,409,393,1727,328,997,207,195,1628,326,902,202,198
  2020 Aug,3271,637,1900,335,399,1725,319,1045,167,194,1546,318,855,168,205
  2020 Jul,3210,680,1815,353,362,1632,350,930,182,170,1578,330,885,171,192
  2020 Jun,3163,649,1781,371,362,1643,346,926,200,171,1520,303,855,171,191
  2020 May,3252,678,1845,351,378,1730,359,963,198,210,1522,319,882,153,168
  2020 Apr,3128,656,1794,332,346,1633,339,931,176,187,1495,317,863,156,159
  2020 Mar,3075,628,1790,347,310,1597,324,897,191,185,1478,304,893,156,125
  2020 Feb,2960,604,1716,328,312,1536,303,918,155,160,1423,301,798,173,151
  2020 Jan,3368,680,1909,388,391,1758,378,982,204,194,1610,302,927,184,197
  2019 Dec,3308,626,1972,382,328,1683,313,984,205,181,1625,313,988,177,147
  2019 Nov,3485,658,2092,363,372,1793,340,1066,197,190,1692,318,1026,166,182
  2019 Oct,3534,666,2124,361,383,1802,347,1078,181,196,1732,319,1046,180,187
  2019 Sep,3452,650,2109,344,349,1743,338,1047,179,179,1709,312,1062,165,170
  2019 Aug,3239,677,1879,340,343,1632,326,959,164,183,1607,351,920,176,160
  2019 Jul,3372,652,2010,353,357,1701,334,1012,178,177,1671,318,998,175,180
  2019 Jun,3119,596,1877,335,311,1565,288,939,170,168,1554,308,938,165,143
  2019 May,3242,629,1908,357,348,1623,308,968,173,174,1619,321,940,184,174
  2019 Apr,3126,639,1786,356,345,1581,316,913,175,177,1545,323,873,181,168
  2019 Mar,3273,638,1912,342,381,1668,332,979,158,199,1605,306,933,184,182
  2019 Feb,2894,547,1734,299,314,1472,269,888,157,158,1422,278,846,142,156
  2019 Jan,3235,637,1902,378,318,1655,334,974,187,160,1580,303,928,191,158
  2018 Dec,3288,619,1869,380,420,1720,325,971,204,220,1567,293,898,176,200
  2018 Nov,3372,638,1990,371,373,1722,332,1011,185,194,1650,306,979,186,179
  2018 Oct,3513,684,2039,410,380,1821,359,1036,230,196,1692,325,1003,180,184
  2018 Sep,3390,690,1926,365,409,1745,346,984,189,226,1645,344,942,176,183
  2018 Aug,3279,640,1948,341,350,1698,311,1024,166,197,1581,329,924,175,153
  2018 Jul,3172,597,1852,380,343,1626,304,966,190,166,1546,293,886,190,177
  2018 Jun,3117,630,1770,341,376,1593,321,910,184,178,1524,309,860,157,198
  2018 May,3200,628,1868,336,368,1637,307,961,173,196,1563,321,907,163,172
  2018 Apr,3110,641,1780,364,325,1588,335,900,192,161,1522,306,880,172,164
  2018 Mar,3367,647,1991,339,390,1747,332,1050,163,202,1620,315,941,176,188
  2018 Feb,2915,561,1675,333,346,1513,309,850,169,185,1402,252,825,164,161
  2018 Jan,3316,617,1942,389,368,1683,314,979,195,195,1633,303,963,194,173
  2017 Dec,3318,627,1888,421,382,1729,351,971,200,207,1589,276,917,221,175
  2017 Nov,3418,689,1989,377,363,1781,345,1060,192,184,1637,344,929,185,179
  2017 Oct,3483,631,2114,350,388,1766,309,1065,172,220,1717,322,1049,178,168
  2017 Sep,3423,616,2044,379,384,1815,343,1045,204,223,1608,273,999,175,161
  2017 Aug,3417,668,1979,376,394,1748,354,1018,181,195,1669,314,961,195,199
  2017 Jul,3323,654,1941,369,359,1691,327,981,201,182,1632,327,960,168,177
  2017 Jun,3137,582,1832,374,349,1606,290,952,177,187,1531,292,880,197,162
  2017 May,3182,591,1846,355,390,1608,283,947,178,200,1574,308,899,177,190
  2017 Apr,3121,587,1815,356,363,1576,284,933,173,186,1545,303,882,183,177
  2017 Mar,3389,566,2077,357,389,1745,297,1047,189,212,1644,269,1030,168,177
  2017 Feb,3020,484,1813,345,378,1590,269,924,195,202,1430,215,889,150,176
  2017 Jan,3384,620,2022,362,380,1753,332,1042,188,191,1631,288,980,174,189
  2016 Dec,3410,585,2088,352,385,1757,292,1062,207,196,1653,293,1026,145,189
  2016 Nov,3465,633,2081,370,381,1754,317,1068,190,179,1711,316,1013,180,202
  2016 Oct,3549,674,2102,385,388,1875,350,1109,214,202,1674,324,993,171,186
  2016 Sep,3684,626,2258,383,417,1864,326,1143,191,204,1820,300,1115,192,213
  2016 Aug,3489,657,2033,392,407,1804,331,1065,193,215,1685,326,968,199,192
  2016 Jul,3449,599,2102,378,370,1833,339,1100,205,189,1616,260,1002,173,181
  2016 Jun,3496,628,2054,363,451,1801,312,1081,187,221,1695,316,973,176,230
  2016 May,3412,574,2034,399,405,1798,310,1068,208,212,1614,264,966,191,193
  2016 Apr,3370,559,2020,381,410,1736,278,1043,197,218,1634,281,977,184,192
  2016 Mar,3513,562,2097,402,452,1854,288,1085,219,262,1659,274,1012,183,190
  2016 Feb,3104,506,1879,325,394,1549,271,905,167,206,1555,235,974,158,188
  2016 Jan,3310,540,2001,369,400,1690,287,1021,177,205,1620,253,980,192,195
  2015 Dec,3700,661,2168,438,433,1941,344,1130,237,230,1759,317,1038,201,203
  2015 Nov,3667,556,2260,438,413,1885,273,1168,237,207,1782,283,1092,201,206
  2015 Oct,3778,641,2289,419,429,1948,319,1202,224,203,1830,322,1087,195,226
  2015 Sep,3786,638,2312,415,421,1929,339,1151,211,228,1857,299,1161,204,193
  2015 Aug,3472,581,2109,395,387,1783,288,1094,208,193,1689,293,1015,187,194
  2015 Jul,3525,558,2123,416,428,1823,287,1107,204,225,1702,271,1016,212,203
  2015 Jun,3304,533,1989,394,388,1720,295,1011,207,207,1584,238,978,187,181
  2015 May,3421,616,1971,427,407,1824,322,1059,228,215,1597,294,912,199,192
  2015 Apr,3364,608,1970,378,408,1656,318,967,186,185,1708,290,1003,192,223
  2015 Mar,3441,511,2110,398,422,1778,267,1062,221,228,1663,244,1048,177,194
  2015 Feb,3027,510,1806,331,380,1548,256,931,168,193,1479,254,875,163,187
  2015 Jan,3700,548,2305,446,401,1920,300,1172,233,215,1780,248,1133,213,186
  2014 Dec,3550,561,2187,397,405,1812,272,1126,199,215,1738,289,1061,198,190
  2014 Nov,3735,538,2328,419,450,1935,274,1213,205,243,1800,264,1115,214,207
  2014 Oct,3906,582,2479,428,417,1983,305,1270,204,204,1923,277,1209,224,213
  2014 Sep,3667,562,2250,410,445,1912,271,1191,213,237,1754,290,1059,197,208
  2014 Aug,3436,510,2123,403,400,1796,250,1115,203,228,1640,260,1008,200,172
  2014 Jul,3567,525,2227,396,419,1809,261,1121,201,226,1758,264,1106,195,193
  2014 Jun,3366,541,2043,352,430,1757,268,1082,182,225,1609,273,961,170,205
  2014 May,3606,598,2130,400,478,1780,303,1081,188,208,1826,295,1049,212,270
  2014 Apr,3494,510,2129,401,454,1780,264,1076,205,235,1714,246,1053,196,219
  2014 Mar,3424,507,2108,372,437,1771,265,1099,184,223,1653,242,1009,188,214
  2014 Feb,3229,487,2010,328,404,1673,250,1066,164,193,1556,237,944,164,211
  2014 Jan,3252,547,1944,372,389,1671,282,1006,199,184,1581,265,938,173,205
  2013 Dec,3369,546,1985,400,438,1733,290,1023,210,210,1636,256,962,190,228
  2013 Nov,3426,512,2063,428,423,1762,276,1073,207,206,1664,236,990,221,217
  2013 Oct,3531,561,2119,418,433,1803,271,1069,234,229,1728,290,1050,184,204
  2013 Sep,3420,539,2006,394,481,1786,278,1050,211,247,1634,261,956,183,234
  2013 Aug,3268,552,1927,376,413,1713,289,1021,183,220,1555,263,906,193,193
  2013 Jul,3176,510,1897,375,394,1629,269,961,182,217,1547,241,936,193,177
  2013 Jun,3207,519,1874,385,429,1642,269,962,193,218,1565,250,912,192,211
  2013 May,3282,516,1945,360,461,1657,262,987,191,217,1625,254,958,169,244
  2013 Apr,3018,427,1784,388,419,1567,214,935,187,231,1451,213,849,201,188
  2013 Mar,3352,484,2074,398,396,1774,251,1101,219,203,1578,233,973,179,193
  2013 Feb,3019,460,1841,334,384,1553,236,944,183,190,1465,224,897,151,193
  2013 Jan,3652,441,2375,392,444,1909,225,1262,198,224,1743,216,1113,194,220
  2012 Dec,3644,490,2269,425,460,1875,243,1186,217,229,1769,247,1083,208,231
  2012 Nov,3838,512,2461,385,480,2015,266,1291,197,261,1823,246,1170,188,219
  2012 Oct,4086,498,2660,433,495,2145,256,1424,216,249,1941,242,1236,217,246
  2012 Sep,3728,517,2393,368,450,1931,264,1248,188,231,1797,253,1145,180,219
  2012 Aug,3727,594,2289,384,460,1952,322,1201,201,228,1775,272,1088,183,232
  2012 Jul,3499,495,2164,379,461,1783,246,1102,194,241,1716,249,1062,185,220
  2012 Jun,3289,481,1981,407,420,1675,256,1020,188,211,1614,225,961,219,209
  2012 May,3502,478,2206,383,435,1809,262,1154,171,222,1693,216,1052,212,213
  2012 Apr,3355,425,2095,386,449,1730,206,1104,195,225,1625,219,991,191,224
  2012 Mar,3453,491,2135,376,451,1786,252,1105,184,245,1667,239,1030,192,206
  2012 Feb,3275,436,2077,368,394,1690,228,1074,181,207,1585,208,1003,187,187
  2012 Jan,3267,491,2030,378,368,1711,246,1089,179,197,1556,245,941,199,171
  2011 Dec,3380,459,2129,380,412,1715,237,1097,178,203,1665,222,1032,202,209
  2011 Nov,3490,490,2189,390,421,1808,240,1162,196,210,1682,250,1027,194,211
  2011 Oct,3583,540,2239,364,440,1804,282,1134,183,205,1779,258,1105,181,235
  2011 Sep,3509,502,2157,419,431,1876,258,1159,232,227,1633,244,998,187,204
  2011 Aug,3262,474,2051,363,374,1689,236,1099,177,177,1573,238,952,186,197
  2011 Jul,3291,473,2089,336,393,1709,232,1082,187,208,1582,241,1007,149,185
  2011 Jun,3338,508,2036,359,435,1721,247,1057,192,225,1617,261,979,167,210
  2011 May,3233,457,2027,358,391,1663,218,1087,182,176,1570,239,940,176,215
  2011 Apr,3249,485,1973,370,421,1630,238,986,181,225,1619,247,987,189,196
  2011 Mar,3423,490,2149,371,413,1772,246,1118,191,217,1651,244,1031,180,196
  2011 Feb,2820,391,1747,313,369,1440,206,886,160,188,1380,185,861,153,181
  2011 Jan,3076,450,1905,353,368,1607,240,987,196,184,1469,210,918,157,184
  2010 Dec,3163,464,1939,347,413,1628,243,1004,168,213,1535,221,935,179,200
  2010 Nov,3201,464,1954,371,412,1709,259,1036,197,217,1492,205,918,174,195
  2010 Oct,3228,530,1911,399,388,1685,280,1009,207,189,1543,250,902,192,199
  2010 Sep,3374,488,2086,384,416,1744,259,1084,186,215,1630,229,1002,198,201
  2010 Aug,3092,501,1897,322,372,1588,283,963,160,182,1504,218,934,162,190
  2010 Jul,3165,479,1905,374,407,1669,266,994,194,215,1495,212,911,180,192
  2010 Jun,3122,479,1861,363,419,1596,236,959,182,219,1526,243,902,181,200
  2010 May,3173,429,1977,373,394,1683,217,1070,188,208,1490,212,907,185,186
  2010 Apr,3129,485,1947,348,349,1561,238,978,174,171,1568,247,969,174,178
  2010 Mar,3252,519,2012,339,382,1663,265,1032,174,192,1589,254,980,165,190
  2010 Feb,2867,399,1808,325,335,1471,196,919,169,187,1396,203,889,156,148
  2010 Jan,3201,474,2006,340,381,1646,219,1051,169,207,1555,255,955,171,174
  2009 Dec,3381,523,2116,361,381,1754,283,1083,194,194,1627,240,1033,167,187
  2009 Nov,3477,498,2231,363,385,1824,272,1151,194,207,1653,226,1080,169,178
  2009 Oct,3654,539,2287,394,434,1872,274,1197,181,220,1782,265,1090,213,214
  2009 Sep,3601,537,2283,395,386,1803,279,1118,206,200,1798,258,1165,189,186
  2009 Aug,3282,515,2061,338,368,1667,260,1031,171,205,1615,255,1030,167,163
  2009 Jul,3251,502,2029,342,378,1668,262,1042,168,196,1583,240,987,174,182
  2009 Jun,3157,502,1928,370,357,1668,256,1019,200,193,1489,246,909,170,164
  2009 May,3123,518,1927,357,321,1670,299,1002,199,170,1453,219,925,158,151
  2009 Apr,3146,504,1933,337,372,1627,242,1009,176,200,1519,262,924,161,172
  2009 Mar,3347,514,2086,344,403,1734,258,1080,184,212,1613,256,1006,160,191
  2009 Feb,3023,452,1924,298,349,1591,227,1014,170,180,1432,225,910,128,169
  2009 Jan,3128,449,1994,297,388,1624,240,1034,151,199,1504,209,960,146,189
  2008 Dec,3388,530,2114,344,400,1773,262,1114,175,222,1615,268,1000,169,178
  2008 Nov,3497,512,2247,365,373,1752,271,1123,180,178,1745,241,1124,185,195
  2008 Oct,3557,506,2291,382,378,1861,265,1198,178,220,1696,241,1093,204,158
  2008 Sep,3601,549,2308,358,386,1871,283,1235,161,192,1730,266,1073,197,194
  2008 Aug,3239,551,2044,330,314,1637,284,1024,171,158,1602,267,1020,159,156
  2008 Jul,3256,573,2044,300,339,1666,293,1044,153,176,1590,280,1000,147,163
  2008 Jun,3175,535,1986,326,328,1613,268,1006,172,167,1562,267,980,154,161
  2008 May,3285,526,2051,350,358,1676,266,1064,179,167,1609,260,987,171,191
  2008 Apr,3236,514,2046,329,347,1702,258,1076,177,191,1534,256,970,152,156
  2008 Mar,3272,549,2085,304,334,1681,270,1069,165,177,1591,279,1016,139,157
  2008 Feb,2983,453,1933,310,287,1545,246,1002,153,144,1438,207,931,157,143
  2008 Jan,3337,507,2182,316,332,1723,242,1137,170,174,1614,265,1045,146,158
  2007 Dec,3369,498,2183,353,335,1778,266,1153,181,178,1590,232,1029,172,157
  2007 Nov,3781,493,2568,362,358,1940,261,1319,187,173,1841,232,1249,175,185
  2007 Oct,3546,545,2300,355,346,1757,259,1145,171,182,1789,286,1155,184,164
  2007 Sep,3541,560,2290,356,335,1851,295,1184,189,183,1690,265,1106,167,152
  2007 Aug,3539,584,2235,371,349,1852,291,1180,201,180,1687,293,1055,170,169
  2007 Jul,3267,576,2047,308,336,1666,280,1053,154,179,1601,296,994,154,157
  2007 Jun,2983,512,1856,323,292,1510,270,924,177,139,1473,242,932,146,153
  2007 May,3267,568,2052,336,311,1713,322,1042,171,178,1554,246,1010,165,133
  2007 Apr,2997,477,1936,295,289,1592,245,1026,160,161,1405,232,910,135,128
  2007 Mar,3154,481,2049,315,309,1624,220,1072,176,156,1530,261,977,139,153
  2007 Feb,2820,466,1782,295,277,1476,256,918,152,150,1344,210,864,143,127
  2007 Jan,3226,492,2092,325,317,1679,257,1089,174,159,1547,235,1003,151,158
  2006 Dec,3223,534,2088,307,294,1687,258,1098,163,168,1536,276,990,144,126
  2006 Nov,3401,527,2221,355,298,1753,273,1147,175,158,1648,254,1074,180,140
  2006 Oct,3543,603,2255,355,330,1875,345,1178,173,179,1668,258,1077,182,151
  2006 Sep,3256,552,2053,352,299,1670,301,1043,165,161,1586,251,1010,187,138
  2006 Aug,3322,626,2075,325,296,1647,305,1044,147,151,1675,321,1031,178,145
  2006 Jul,3244,523,2150,285,286,1721,286,1149,156,130,1523,237,1001,129,156
  2006 Jun,3040,523,1936,322,259,1558,274,1000,161,123,1482,249,936,161,136
  2006 May,3212,515,2078,336,283,1673,250,1107,177,139,1539,265,971,159,144
  2006 Apr,3077,549,1991,307,230,1566,279,1018,147,122,1511,270,973,160,108
  2006 Mar,3066,520,1984,308,254,1535,267,1008,140,120,1531,253,976,168,134
  2006 Feb,2873,476,1857,292,248,1502,255,933,179,135,1371,221,924,113,113
  2006 Jan,3060,543,1958,299,260,1563,271,1008,156,128,1497,272,950,143,132
  2005 Dec,3082,529,1976,320,257,1595,248,1048,163,136,1487,281,928,157,121
  2005 Nov,3250,512,2174,314,250,1675,266,1127,156,126,1575,246,1047,158,124
  2005 Oct,3371,598,2196,312,265,1771,307,1154,154,156,1600,291,1042,158,109
  2005 Sep,3439,588,2238,327,286,1747,296,1141,171,139,1692,292,1097,156,147
  2005 Aug,3156,570,2034,310,242,1630,307,1049,151,123,1526,263,985,159,119
  2005 Jul,3119,585,1969,294,271,1628,298,1023,159,148,1491,287,946,135,123
  2005 Jun,3163,555,2016,334,258,1632,288,1039,170,135,1531,267,977,164,123
  2005 May,3231,575,2095,321,240,1689,303,1118,162,106,1542,272,977,159,134
  2005 Apr,3037,524,1985,298,230,1563,275,994,172,122,1474,249,991,126,108
  2005 Mar,3024,534,1941,291,258,1550,275,995,153,127,1474,259,946,138,131
  2005 Feb,2699,439,1791,261,208,1314,203,866,145,100,1385,236,925,116,108
  2005 Jan,2921,502,1898,290,231,1558,276,1019,143,120,1363,226,879,147,111
  2004 Dec,3143,537,2056,312,238,1596,275,1041,158,122,1547,262,1015,154,116
  2004 Nov,3365,557,2231,329,248,1752,279,1187,168,118,1613,278,1044,161,130
  2004 Oct,3547,572,2353,315,307,1827,296,1212,153,166,1720,276,1141,162,141
  2004 Sep,3219,598,2067,289,265,1655,294,1073,146,142,1564,304,994,143,123
  2004 Aug,3079,561,2030,268,220,1623,305,1057,133,128,1456,256,973,135,92
  2004 Jul,2981,516,1917,279,269,1551,280,995,130,146,1430,236,922,149,123
  2004 Jun,3047,541,1949,307,250,1563,281,1027,146,109,1484,260,922,161,141
  2004 May,3008,567,1866,309,266,1550,295,951,169,135,1458,272,915,140,131
  2004 Apr,2896,565,1795,308,228,1539,298,944,176,121,1357,267,851,132,107
  2004 Mar,3128,572,2018,278,260,1610,290,1032,145,143,1518,282,986,133,117
  2004 Feb,2824,466,1874,279,205,1415,237,922,146,110,1409,229,952,133,95
  2004 Jan,2937,521,1904,268,244,1540,275,986,137,142,1397,246,918,131,102
  2003 Dec,3197,567,2057,290,283,1642,291,1035,155,161,1555,276,1022,135,122
  2003 Nov,3150,598,1997,295,260,1660,294,1083,149,134,1490,304,914,146,126
  2003 Oct,3384,599,2193,347,245,1736,291,1142,187,116,1648,308,1051,160,129
  2003 Sep,3168,578,2051,301,238,1608,296,1041,144,127,1560,282,1010,157,111
  2003 Aug,3182,553,2088,313,228,1653,283,1074,174,122,1529,270,1014,139,106
  2003 Jul,3052,509,2002,307,234,1578,249,1046,152,131,1474,260,956,155,103
  2003 Jun,2967,510,1906,336,215,1482,234,977,169,102,1485,276,929,167,113
  2003 May,3142,635,1993,288,226,1606,324,1016,152,114,1536,311,977,136,112
  2003 Apr,3113,555,2051,276,231,1600,291,1046,147,116,1513,264,1005,129,115
  2003 Mar,3117,542,2056,287,232,1624,274,1075,154,121,1493,268,981,133,111
  2003 Feb,2766,479,1824,275,188,1410,256,927,134,93,1356,223,897,141,95
  2003 Jan,3247,572,2108,317,250,1669,309,1083,163,114,1578,263,1025,154,136
  2002 Dec,3539,606,2344,328,261,1791,297,1201,160,133,1748,309,1143,168,128
  2002 Nov,3592,643,2350,343,256,1819,324,1179,184,132,1773,319,1171,159,124
  2002 Oct,3669,661,2421,336,251,1878,358,1225,165,130,1791,303,1196,171,121
  2002 Sep,3504,566,2325,336,277,1794,288,1200,171,135,1710,278,1125,165,142
  2002 Aug,3443,585,2298,309,251,1780,296,1212,147,125,1663,289,1086,162,126
  2002 Jul,3403,652,2231,280,240,1760,351,1132,153,124,1643,301,1099,127,116
  2002 Jun,3131,571,1992,312,256,1658,282,1056,178,142,1473,289,936,134,114
  2002 May,3484,647,2259,342,236,1790,337,1134,188,131,1693,310,1124,154,105
  2002 Apr,3311,587,2232,288,204,1744,300,1199,138,107,1566,287,1032,150,97
  2002 Mar,3295,618,2137,315,225,1692,313,1093,168,118,1602,304,1044,147,107
  2002 Feb,3046,542,1955,323,226,1547,268,1001,166,112,1499,274,954,157,114
  2002 Jan,3343,590,2238,303,212,1724,317,1141,158,108,1619,273,1097,145,104
  2001 Dec,3390,606,2209,328,247,1727,296,1150,156,125,1663,310,1059,172,122
  2001 Nov,3499,699,2223,337,240,1798,378,1139,154,127,1701,321,1084,183,113
  2001 Oct,3680,674,2421,333,252,1911,347,1276,162,126,1769,327,1145,171,126
  2001 Sep,3383,653,2181,297,252,1783,363,1124,158,138,1600,290,1057,139,114
  2001 Aug,3484,706,2230,322,226,1840,390,1145,180,125,1644,316,1085,142,101
  2001 Jul,3357,694,2131,282,250,1751,379,1088,147,137,1606,315,1043,135,113
  2001 Jun,3354,665,2156,289,244,1731,338,1130,138,125,1623,327,1026,151,119
  2001 May,3563,703,2279,320,261,1868,358,1201,176,133,1695,345,1078,144,128
  2001 Apr,3455,652,2249,324,230,1785,347,1159,160,119,1670,305,1090,164,111
  2001 Mar,3410,594,2281,295,240,1751,315,1160,153,123,1659,279,1121,142,117
  2001 Feb,3222,558,2198,271,195,1671,280,1134,145,112,1551,278,1064,126,83
  2001 Jan,3654,612,2505,314,223,1878,313,1285,168,112,1776,299,1220,146,111
  2000 Dec,3880,655,2652,313,260,2040,360,1388,170,122,1840,295,1264,143,138
  2000 Nov,4308,728,2962,366,252,2178,396,1474,196,112,2130,332,1488,170,140
  2000 Oct,4288,745,2924,357,262,2293,404,1563,184,142,1995,341,1361,173,120
  2000 Sep,4147,690,2878,322,257,2157,363,1480,182,132,1990,327,1398,140,125
  2000 Aug,4019,691,2784,307,237,2164,370,1485,167,142,1855,321,1299,140,95
  2000 Jul,3954,733,2694,302,225,2089,374,1441,157,117,1865,359,1253,145,108
  2000 Jun,3618,659,2420,310,229,1906,332,1279,168,127,1712,327,1141,142,102
  2000 May,4004,742,2672,339,251,2030,382,1355,173,120,1974,360,1317,166,131
  2000 Apr,3642,647,2489,270,236,1916,326,1311,151,128,1726,321,1178,119,108
  2000 Mar,3916,691,2669,325,231,2046,359,1387,158,142,1870,332,1282,167,89
  2000 Feb,3636,657,2464,310,205,1880,338,1267,163,112,1756,319,1197,147,93
  2000 Jan,3585,671,2359,329,226,1810,324,1199,165,122,1775,347,1160,164,104
  1999 Dec,3776,709,2514,339,214,1993,374,1325,182,112,1783,335,1189,157,102
  1999 Nov,3810,676,2559,337,238,2002,338,1371,181,112,1808,338,1188,156,126
  1999 Oct,3689,688,2468,310,223,1902,337,1297,151,117,1787,351,1171,159,106
  1999 Sep,3727,645,2516,312,254,1951,339,1317,164,131,1776,306,1199,148,123
  1999 Aug,3647,701,2420,298,228,1863,361,1231,154,117,1784,340,1189,144,111
  1999 Jul,3556,654,2394,300,208,1851,334,1262,146,109,1705,320,1132,154,99
  1999 Jun,3466,678,2256,314,218,1823,370,1191,163,99,1643,308,1065,151,119
  1999 May,3794,715,2496,338,245,2010,383,1324,174,129,1784,332,1172,164,116
  1999 Apr,3603,698,2426,251,228,1888,382,1294,115,97,1715,316,1132,136,131
  1999 Mar,3738,634,2554,327,223,1924,319,1307,175,123,1814,315,1247,152,100
  1999 Feb,3082,537,2102,248,195,1546,264,1056,114,112,1535,273,1045,134,83
  1999 Jan,3448,659,2268,277,244,1819,353,1187,149,130,1629,306,1081,128,114
  1998 Dec,3532,662,2299,337,234,1849,342,1203,187,117,1683,320,1096,150,117
  1998 Nov,3500,713,2266,314,207,1836,386,1177,167,106,1664,327,1089,147,101
  1998 Oct,3933,726,2594,376,237,2048,391,1336,205,116,1885,335,1258,171,121
  1998 Sep,3665,717,2386,340,222,1924,373,1232,193,126,1741,344,1154,147,96
  1998 Aug,3787,779,2424,342,242,1999,418,1282,167,132,1788,361,1142,175,110
  1998 Jul,3590,750,2291,338,211,1825,408,1158,156,103,1765,342,1133,182,108
  1998 Jun,3555,654,2381,287,233,1809,329,1225,141,114,1746,325,1156,146,119
  1998 May,3721,727,2408,350,236,1924,374,1258,189,103,1797,353,1150,161,133
  1998 Apr,3593,698,2391,302,202,1804,356,1203,154,91,1789,342,1188,148,111
  1998 Mar,3701,717,2460,292,232,1905,376,1253,154,122,1795,341,1207,138,109
  1998 Feb,3337,631,2199,298,209,1685,317,1103,158,107,1652,314,1096,140,102
  1998 Jan,3750,702,2542,309,197,1897,361,1309,149,78,1853,341,1233,160,119
  1997 Dec,4195,792,2819,340,244,2167,402,1465,172,128,2028,390,1354,168,116
  1997 Nov,4287,783,2915,377,212,2184,382,1525,177,100,2102,400,1390,200,112
  1997 Oct,4638,781,3271,349,237,2452,410,1740,173,129,2186,371,1531,176,108
  1997 Sep,4290,788,2919,346,237,2223,399,1515,189,120,2067,389,1404,157,117
  1997 Aug,3884,750,2568,336,230,2012,381,1336,174,121,1871,368,1232,162,109
  1997 Jul,3932,688,2756,295,193,2076,366,1455,147,108,1856,322,1301,148,85
  1997 Jun,3712,700,2519,294,199,1923,362,1323,143,95,1789,338,1196,151,104
  1997 May,3793,715,2552,326,200,1932,367,1297,164,104,1861,348,1255,162,96
  1997 Apr,3665,668,2486,303,208,1923,349,1310,155,109,1742,319,1176,148,99
  1997 Mar,3646,680,2454,294,218,1887,343,1271,156,117,1759,337,1183,138,101
  1997 Feb,3328,583,2303,259,183,1720,320,1180,126,94,1608,263,1123,133,89
  1997 Jan,3963,699,2723,314,227,2054,356,1411,170,117,1909,343,1312,144,110
  1996 Dec,4310,798,2931,365,216,2228,406,1525,184,113,2082,392,1406,181,103
  1996 Nov,4539,805,3136,339,259,2385,425,1629,176,155,2153,380,1507,162,104
  1996 Oct,4396,812,2990,355,239,2268,408,1539,198,123,2127,403,1451,157,116
  1996 Sep,4187,812,2812,328,235,2169,420,1469,161,119,2018,392,1343,167,116
  1996 Aug,4068,775,2731,349,213,2144,437,1420,184,103,1924,338,1311,165,110
  1996 Jul,3953,721,2725,303,204,2069,362,1443,169,95,1884,359,1282,134,109
  1996 Jun,3756,658,2579,294,225,1919,337,1311,154,117,1837,321,1268,140,108
  1996 May,4029,743,2730,334,222,2115,385,1429,182,119,1914,358,1301,152,103
  1996 Apr,3838,694,2678,282,184,2050,355,1444,146,105,1788,339,1234,136,79
  1996 Mar,4002,740,2795,277,190,2105,388,1475,138,104,1897,352,1320,139,86
  1996 Feb,3517,659,2419,266,173,1858,342,1277,144,95,1659,317,1142,122,78
  1996 Jan,3982,758,2704,326,194,1996,370,1365,158,103,1986,388,1339,168,91
  1995 Dec,4282,784,2981,306,211,2145,382,1508,145,110,2137,402,1473,161,101
  1995 Nov,4253,735,2938,358,222,2189,374,1503,200,112,2064,361,1435,158,110
  1995 Oct,4413,795,3056,317,245,2317,431,1590,164,132,2096,364,1466,153,113
  1995 Sep,4224,806,2878,324,216,2188,426,1500,155,107,2036,380,1378,169,109
  1995 Aug,4153,793,2839,333,188,2132,410,1454,168,100,2021,383,1385,165,88
  1995 Jul,4094,835,2746,306,207,2123,452,1417,148,106,1970,382,1329,158,101
  1995 Jun,3995,715,2777,325,178,2100,380,1455,172,93,1895,335,1322,153,85
  1995 May,4051,762,2728,337,224,2157,405,1439,187,126,1894,357,1289,150,98
  1995 Apr,3758,690,2605,276,187,1985,341,1411,143,90,1773,349,1194,133,97
  1995 Mar,3982,785,2718,294,185,2089,408,1424,159,98,1893,377,1294,135,87
  1995 Feb,3678,702,2538,270,168,1936,379,1324,148,85,1742,323,1214,122,83
  1995 Jan,3752,691,2580,291,190,1934,342,1353,146,93,1818,349,1227,145,97
  1994 Dec,4398,832,3001,383,182,2262,445,1530,206,81,2136,387,1471,177,101
  1994 Nov,4315,731,3068,355,161,2164,369,1554,171,70,2151,362,1514,184,91
  1994 Oct,4620,861,3225,335,199,2425,464,1684,175,102,2195,397,1541,160,97
  1994 Sep,4356,846,2970,329,211,2256,428,1563,168,97,2100,418,1407,161,114
  1994 Aug,4155,791,2849,318,197,2130,397,1486,154,93,2025,394,1363,164,104
  1994 Jul,4036,800,2735,322,179,2041,396,1387,165,93,1995,404,1348,157,86
  1994 Jun,4027,786,2771,296,174,2083,400,1441,153,89,1944,386,1330,143,85
  1994 May,4073,769,2785,317,202,2118,421,1425,166,106,1955,348,1360,151,96
  1994 Apr,3905,712,2761,269,163,2024,348,1459,136,81,1881,364,1302,133,82
  1994 Mar,4125,767,2845,324,189,2130,411,1442,181,96,1995,356,1403,143,93
  1994 Feb,3574,700,2404,297,173,1880,379,1261,154,86,1694,321,1143,143,87
  1994 Jan,3970,817,2666,319,168,2028,420,1342,179,87,1942,397,1324,140,81
  1993 Dec,4477,853,3066,368,190,2269,446,1539,184,100,2208,407,1527,184,90
  1993 Nov,4384,792,3061,345,186,2260,424,1564,171,101,2124,368,1497,174,85
  1993 Oct,4746,910,3285,367,184,2463,482,1712,177,92,2281,427,1572,190,92
  1993 Sep,4456,941,2942,395,178,2253,456,1517,199,81,2203,485,1425,196,97
  1993 Aug,4336,863,2943,351,179,2240,454,1514,181,91,2096,409,1429,170,88
  1993 Jul,4287,864,2903,340,180,2204,432,1522,162,88,2082,432,1380,178,92
  1993 Jun,4115,829,2752,340,194,2081,394,1413,179,95,2034,435,1339,161,99
  1993 May,4094,744,2870,310,170,2108,388,1484,151,85,1986,356,1386,159,85
  1993 Apr,3805,733,2574,317,181,1996,395,1337,164,100,1809,338,1237,153,81
  1993 Mar,4079,785,2805,316,173,2129,414,1473,168,74,1950,371,1332,148,99
  1993 Feb,3723,741,2520,295,167,1948,391,1321,152,84,1775,350,1199,143,83
  1993 Jan,3723,754,2530,278,161,1997,412,1368,140,77,1726,342,1162,138,84
  1992 Dec,4382,814,3054,327,187,2293,421,1602,172,98,2089,393,1452,155,89
  1992 Nov,4394,833,3034,352,175,2253,395,1574,185,99,2141,438,1460,167,76
  1992 Oct,4765,930,3264,382,189,2463,464,1700,204,95,2302,466,1564,178,94
  1992 Sep,4498,911,3024,358,205,2326,493,1559,184,90,2172,418,1465,174,115
  1992 Aug,4152,866,2753,346,187,2208,466,1460,192,90,1944,400,1293,154,97
  1992 Jul,4131,826,2796,337,172,2169,438,1462,173,96,1962,388,1334,164,76
  1992 Jun,3868,768,2605,328,167,1952,389,1322,161,80,1916,379,1283,167,87
  1992 May,3860,762,2612,319,167,1959,361,1349,171,78,1901,401,1263,148,89
  1992 Apr,3713,733,2552,264,164,1944,380,1349,128,87,1769,353,1203,136,77
  1992 Mar,4027,781,2726,332,188,2010,393,1346,171,100,2017,388,1380,161,88
  1992 Feb,3667,736,2443,337,151,1907,370,1281,179,77,1759,365,1162,158,74
  1992 Jan,3945,823,2612,342,168,1981,397,1326,174,84,1964,426,1286,168,84
  1991 Dec,4469,851,3077,357,184,2308,426,1592,202,88,2161,425,1485,155,96
  1991 Nov,4355,884,2956,338,177,2232,461,1528,152,91,2123,423,1428,186,86
  1991 Oct,4590,983,3072,357,178,2334,513,1564,168,89,2256,470,1508,189,89
  1991 Sep,4375,890,2945,349,191,2279,459,1536,177,107,2096,431,1409,172,84
  1991 Aug,4148,817,2842,317,172,2113,407,1460,163,83,2035,410,1382,154,89
  1991 Jul,4058,791,2775,324,168,2034,404,1408,149,73,2024,387,1367,175,95
  1991 Jun,3759,747,2563,285,164,1906,377,1303,146,80,1853,370,1260,139,84
  1991 May,4083,882,2740,306,155,2118,480,1399,162,77,1964,402,1340,144,78
  1991 Apr,3718,753,2551,245,169,1994,397,1376,133,88,1724,356,1175,112,81
  1991 Mar,3919,799,2672,288,160,1983,413,1356,130,84,1936,386,1316,158,76
  1991 Feb,3570,718,2403,294,155,1911,387,1292,144,88,1659,331,1111,150,67
  1991 Jan,4070,763,2827,344,136,2102,398,1444,182,78,1967,364,1383,162,58
  1990 Dec,4591,840,3220,359,172,2364,429,1676,170,89,2227,411,1544,189,83
  1990 Nov,4876,931,3403,380,162,2540,505,1761,185,89,2336,426,1642,195,73
  1990 Oct,5263,962,3740,394,167,2768,511,1953,208,96,2494,450,1787,186,71
  1990 Sep,4668,941,3222,338,167,2416,478,1684,162,92,2252,463,1538,176,75
  1990 Aug,4403,853,3044,337,169,2271,437,1578,170,86,2132,416,1466,167,83
  1990 Jul,4196,776,2920,350,150,2152,405,1479,182,86,2044,371,1441,168,64
  1990 Jun,4006,749,2791,322,144,2093,376,1478,171,68,1913,373,1313,151,76
  1990 May,4138,833,2788,342,175,2198,445,1487,179,87,1940,388,1301,163,88
  1990 Apr,3717,746,2553,257,161,1878,367,1306,128,77,1839,379,1247,129,84
  1990 Mar,3958,776,2710,300,172,2025,368,1432,138,87,1933,408,1278,162,85
  1990 Feb,3586,766,2429,254,137,1842,372,1275,124,71,1744,394,1154,130,66
  1990 Jan,3740,770,2476,342,152,1953,407,1290,169,87,1787,363,1186,173,65
  1989 Dec,4337,879,2946,332,180,2228,417,1552,169,90,2108,461,1394,163,90
  1989 Nov,4347,911,2929,345,162,2267,478,1543,167,79,2077,433,1383,178,83
  1989 Oct,4485,978,2958,381,168,2326,503,1525,204,94,2159,475,1433,177,74
  1989 Sep,4301,971,2837,343,150,2253,515,1481,177,80,2048,456,1356,166,70
  1989 Aug,4026,776,2747,349,154,2071,417,1390,182,82,1955,359,1357,167,72
  1989 Jul,3783,767,2574,269,173,1950,379,1328,149,94,1832,387,1246,120,79
  1989 Jun,3719,785,2509,279,146,1963,411,1321,152,79,1756,374,1188,127,67
  1989 May,3783,768,2585,271,159,1974,381,1383,135,75,1809,387,1202,136,84
  1989 Apr,3588,749,2426,251,162,1883,403,1260,135,85,1704,346,1165,116,77
  1989 Mar,3899,774,2666,336,123,2013,389,1394,165,65,1886,385,1272,171,58
  1989 Feb,3411,647,2332,299,133,1773,330,1230,144,69,1638,317,1102,155,64
  1989 Jan,3990,736,2821,308,125,2011,351,1435,160,65,1979,385,1386,148,60
  1988 Dec,4722,831,3402,328,161,2472,464,1738,175,95,2250,367,1664,153,66
  1988 Nov,5180,862,3799,356,163,2609,426,1920,189,74,2571,436,1879,167,89
  1988 Oct,5478,902,4022,374,180,2831,469,2091,191,80,2647,433,1931,183,100
  1988 Sep,5243,882,3866,342,153,2671,444,1986,168,73,2572,438,1880,174,80
  1988 Aug,4643,738,3488,277,140,2439,386,1831,153,69,2204,352,1657,124,71
  1988 Jul,4441,732,3279,290,140,2240,385,1628,153,74,2201,347,1651,137,66
  1988 Jun,4233,733,3042,314,144,2203,391,1587,159,66,2030,342,1455,155,78
  1988 May,4181,768,2942,324,147,2170,399,1526,169,76,2011,369,1416,155,71
  1988 Apr,3834,707,2737,256,134,2002,358,1453,134,57,1831,349,1283,122,77
  1988 Mar,4070,734,2876,309,151,2135,390,1518,154,73,1935,344,1358,155,78
  1988 Feb,3501,636,2480,253,132,1804,328,1257,147,72,1697,308,1223,106,60
  1988 Jan,3431,699,2312,293,127,1756,367,1188,144,57,1675,332,1124,149,70
  1987 Dec,4117,791,2827,343,156,2155,415,1477,177,86,1962,376,1350,166,70
  1987 Nov,4167,810,2880,315,162,2105,398,1455,162,90,2062,412,1425,153,72
  1987 Oct,4403,870,3010,342,181,2321,455,1606,168,92,2081,414,1404,174,89
  1987 Sep,3929,799,2633,343,154,2027,406,1377,164,80,1901,393,1255,179,74
  1987 Aug,3773,745,2595,298,135,1920,379,1311,154,76,1853,366,1284,144,59
  1987 Jul,3678,707,2576,258,137,1913,353,1342,140,78,1765,354,1234,118,59
  1987 Jun,3726,714,2568,317,127,1923,353,1344,160,66,1802,360,1224,157,61
  1987 May,3566,704,2470,256,136,1861,368,1278,142,73,1705,336,1192,114,63
  1987 Apr,3311,665,2265,238,143,1712,354,1167,120,71,1599,311,1098,118,72
  1987 Mar,3506,721,2370,279,136,1848,366,1261,149,72,1658,355,1109,130,64
  1987 Feb,2682,525,1849,200,108,1385,271,942,112,60,1297,254,907,88,48
  1987 Jan,2758,585,1796,252,125,1400,289,923,119,69,1357,295,873,133,56
  1986 Dec,3130,696,1989,300,145,1627,354,1045,161,67,1503,342,944,139,78
  1986 Nov,3289,749,2117,282,141,1665,371,1079,141,74,1624,378,1038,141,67
  1986 Oct,3605,750,2372,327,156,1899,360,1263,187,89,1706,390,1109,140,67
  1986 Sep,3357,670,2238,309,140,1714,326,1164,162,62,1643,344,1074,147,78
  1986 Aug,3318,682,2210,288,138,1737,357,1160,152,68,1581,325,1050,136,70
  1986 Jul,3268,667,2212,254,135,1704,325,1178,126,75,1564,342,1034,128,60
  1986 Jun,3095,677,2041,250,127,1628,349,1089,136,54,1467,328,952,114,73
  1986 May,3154,711,2059,244,140,1644,379,1065,129,71,1508,332,992,115,69
  1986 Apr,3047,686,1996,227,138,1547,352,1024,102,69,1500,334,972,125,69
  1986 Mar,3166,640,2108,271,147,1634,337,1074,149,74,1531,303,1034,121,73
  1986 Feb,2668,532,1819,206,111,1401,291,936,118,56,1267,241,883,88,55
  1986 Jan,3282,664,2200,253,165,1729,350,1150,141,88,1553,314,1050,112,77
  1985 Dec,3609,702,2457,302,148,1894,366,1308,153,67,1715,336,1149,149,81
  1985 Nov,3907,694,2766,294,152,2036,348,1447,158,83,1870,346,1319,136,69
  1985 Oct,4059,810,2795,301,153,2126,421,1466,161,78,1933,389,1329,140,75
  1985 Sep,3714,724,2545,291,153,1910,364,1317,150,79,1803,360,1228,141,74
  1985 Aug,3651,671,2555,277,148,1951,354,1375,142,80,1700,317,1180,135,68
  1985 Jul,3593,667,2526,274,124,1831,352,1286,135,58,1760,315,1240,139,66
  1985 Jun,3355,625,2313,277,139,1697,307,1197,124,69,1657,318,1116,153,70
  1985 May,3473,691,2342,287,153,1787,361,1197,149,80,1686,330,1145,138,73
  1985 Apr,3284,650,2243,249,142,1669,323,1130,139,77,1615,327,1113,110,65
  1985 Mar,3344,616,2354,231,143,1709,326,1210,107,66,1635,290,1144,124,77
  1985 Feb,3070,554,2144,231,141,1613,260,1143,130,80,1457,294,1001,101,61
  1985 Jan,3425,699,2312,266,148,1804,358,1219,148,79,1621,341,1093,118,69
  1984 Dec,3849,699,2717,311,122,1969,372,1382,155,60,1880,327,1335,156,62
  1984 Nov,3893,719,2707,322,145,1980,363,1396,147,74,1913,356,1311,175,71
  1984 Oct,4135,782,2923,291,139,2183,419,1545,153,66,1952,363,1378,138,73
  1984 Sep,3799,691,2651,299,158,1990,338,1411,163,78,1809,353,1240,136,80
  1984 Aug,3603,683,2448,293,179,1919,361,1309,155,94,1684,322,1139,138,85
  1984 Jul,3391,632,2383,240,135,1749,312,1251,125,61,1641,320,1132,115,74
  1984 Jun,3200,646,2169,266,119,1637,328,1098,157,54,1563,318,1071,109,65
  1984 May,3265,684,2186,249,146,1689,330,1145,142,72,1576,354,1041,107,74
  1984 Apr,3164,649,2136,237,142,1675,362,1127,121,65,1489,287,1009,116,77
  1984 Mar,3286,582,2305,251,148,1741,326,1217,120,78,1545,256,1088,131,70
  1984 Feb,2938,544,2059,205,130,1525,295,1065,102,63,1413,249,994,103,67
  1984 Jan,3033,589,2060,258,126,1604,296,1100,133,75,1429,293,960,125,51
  1983 Dec,3411,629,2386,264,132,1745,308,1226,131,80,1666,321,1160,133,52
  1983 Nov,3596,652,2516,278,150,1864,327,1330,130,77,1732,325,1186,148,73
  1983 Oct,3754,671,2640,292,151,1928,356,1336,171,65,1826,315,1304,121,86
  1983 Sep,3645,671,2554,295,124,1883,347,1328,143,65,1761,324,1226,152,59
  1983 Aug,3451,596,2443,276,136,1743,294,1256,128,65,1708,302,1187,148,71
  1983 Jul,3426,635,2409,257,125,1788,320,1269,128,71,1638,315,1140,129,54
  1983 Jun,3392,684,2302,268,138,1798,369,1243,132,54,1594,315,1059,136,84
  1983 May,3381,653,2346,237,144,1749,350,1221,111,67,1631,303,1125,126,77
  1983 Apr,3087,579,2194,198,116,1600,307,1130,105,58,1487,272,1064,93,58
  1983 Mar,3179,592,2185,253,148,1650,295,1143,131,81,1528,297,1042,122,67
  1983 Feb,2977,549,2069,229,130,1616,289,1136,128,63,1361,260,933,101,67
  1983 Jan,3286,616,2277,268,125,1685,312,1167,137,69,1601,304,1110,131,56
  1982 Dec,3844,668,2743,295,138,2000,337,1444,155,64,1844,331,1299,140,74
  1982 Nov,3951,683,2820,301,147,2046,352,1453,161,80,1905,331,1367,140,67
  1982 Oct,4413,724,3171,351,166,2245,378,1595,182,90,2167,346,1576,169,76
  1982 Sep,3963,687,2812,311,153,2078,354,1497,151,76,1885,333,1315,160,77
  1982 Aug,3673,598,2679,251,145,1956,318,1408,157,73,1717,280,1271,94,72
  1982 Jul,3515,641,2473,240,160,1814,327,1268,130,89,1700,314,1205,110,71
  1982 Jun,3563,585,2571,249,158,1881,278,1370,140,93,1682,307,1201,109,65
  1982 May,3296,575,2318,250,153,1737,311,1205,139,82,1559,264,1113,111,71
  1982 Apr,3086,526,2227,216,117,1629,270,1180,121,58,1457,256,1047,95,59
  1982 Mar,3282,553,2349,225,155,1717,295,1211,124,87,1565,258,1138,101,68
  1982 Feb,2909,509,2063,223,114,1496,263,1072,107,54,1413,246,991,116,60
  1982 Jan,3159,565,2276,213,105,1686,295,1210,117,64,1473,270,1066,96,41
  1981 Dec,3668,590,2641,302,134,1895,317,1347,168,63,1772,273,1294,134,71
  1981 Nov,3875,656,2804,267,148,2046,317,1514,143,72,1829,339,1290,124,76
  1981 Oct,4150,694,3034,276,146,2143,353,1586,129,75,2007,341,1448,147,71
  1981 Sep,3722,647,2669,252,153,1980,356,1419,124,81,1741,291,1250,128,72
  1981 Aug,3659,635,2622,247,155,1892,340,1348,127,77,1767,295,1274,120,78
  1981 Jul,3535,561,2567,256,151,1825,289,1335,130,71,1710,272,1232,126,80
  1981 Jun,3499,600,2535,249,115,1764,307,1273,126,58,1735,293,1262,123,57
  1981 May,3456,657,2428,239,132,1769,345,1249,112,63,1687,312,1179,127,69
  1981 Apr,3200,558,2291,210,141,1600,273,1153,113,61,1600,285,1138,97,80
  1981 Mar,3244,529,2378,228,109,1698,283,1241,114,60,1546,246,1137,114,49
  1981 Feb,2984,467,2144,222,149,1583,265,1142,100,76,1399,202,1002,122,73
  1981 Jan,3258,537,2375,231,115,1715,278,1253,124,60,1543,259,1122,107,55
  1980 Dec,3491,536,2579,236,140,1749,264,1293,120,72,1742,272,1286,116,68
  1980 Nov,3656,565,2680,285,126,1906,306,1386,143,71,1750,259,1294,142,55
  1980 Oct,3991,614,2944,283,150,2072,323,1526,142,81,1919,291,1418,141,69
  1980 Sep,3790,641,2763,249,137,2044,354,1475,138,77,1746,287,1288,111,60
  1980 Aug,3780,600,2755,262,162,1937,284,1437,133,83,1842,316,1318,129,79
  1980 Jul,3613,597,2658,222,136,1822,303,1342,111,66,1791,294,1316,111,70
  1980 Jun,3163,528,2302,222,111,1654,267,1206,122,59,1509,261,1096,100,52
  1980 May,3164,556,2252,226,130,1687,291,1216,114,66,1477,265,1036,112,64
  1980 Apr,3087,502,2257,208,120,1556,256,1145,105,50,1531,246,1112,103,70
  1980 Mar,3319,544,2399,260,116,1708,293,1240,114,61,1611,251,1159,146,55
  1980 Feb,3026,498,2220,206,102,1539,249,1134,103,53,1487,249,1086,103,49
  1980 Jan,3137,473,2333,224,107,1634,250,1226,103,55,1503,223,1107,121,52
  1979 Dec,3581,502,2649,296,134,1890,269,1389,159,73,1691,233,1260,137,61
  1979 Nov,3514,502,2647,250,115,1812,271,1355,132,54,1702,231,1292,118,61
  1979 Oct,3982,562,3045,249,126,2106,303,1599,134,70,1876,259,1446,115,56
  1979 Sep,3706,515,2794,265,132,1964,265,1492,127,80,1742,250,1302,138,52
  1979 Aug,3677,475,2853,221,127,1965,270,1508,118,69,1711,205,1345,103,58
  1979 Jul,3294,460,2504,213,117,1681,227,1281,113,60,1613,233,1223,100,57
  1979 Jun,3284,459,2512,211,102,1694,222,1314,107,51,1590,237,1198,104,51
  1979 May,3194,495,2378,218,103,1681,259,1269,96,57,1513,236,1109,122,46
  1979 Apr,3101,442,2368,174,117,1614,230,1220,92,72,1487,212,1148,82,45
  1979 Mar,3311,451,2542,202,116,1714,236,1303,114,61,1597,215,1239,88,55
  1979 Feb,2972,399,2271,185,117,1545,201,1185,97,62,1427,198,1086,88,55
  1979 Jan,3163,493,2362,200,108,1627,253,1212,102,60,1536,240,1150,98,48
  1978 Dec,3429,489,2580,240,119,1765,251,1332,126,56,1663,238,1248,114,63
  1978 Nov,3678,460,2875,224,119,1879,234,1479,108,58,1799,226,1396,116,61
  1978 Oct,3696,506,2834,238,118,1983,270,1514,122,77,1713,236,1320,116,41
  1978 Sep,3551,502,2737,212,100,1799,247,1395,100,57,1752,255,1342,112,43
  1978 Aug,3507,489,2676,227,115,1781,238,1374,105,64,1726,251,1302,122,51
  1978 Jul,3405,479,2605,212,109,1784,261,1353,115,55,1621,218,1252,97,54
  1978 Jun,3224,471,2470,185,98,1670,234,1301,86,49,1554,237,1169,99,49
  1978 May,3103,449,2365,192,97,1596,230,1220,93,53,1507,219,1145,99,44
  1978 Apr,3020,461,2282,183,94,1595,239,1206,103,47,1425,222,1076,80,47
  1978 Mar,3199,460,2474,179,86,1619,239,1253,87,40,1580,221,1221,92,46
  1978 Feb,2670,363,2033,177,97,1377,180,1044,97,56,1293,183,989,80,41
  1978 Jan,2959,394,2246,203,116,1516,191,1159,111,55,1443,203,1087,92,61
  1977 Dec,3389,492,2574,222,101,1760,273,1325,109,53,1629,219,1249,113,48
  1977 Nov,3413,460,2635,212,106,1809,249,1388,111,61,1604,211,1247,101,45
  1977 Oct,3689,510,2837,211,131,1887,264,1450,114,59,1802,246,1387,97,72
  1977 Sep,3388,471,2611,198,108,1726,240,1327,97,62,1662,231,1284,101,46
  1977 Aug,3257,490,2471,203,93,1745,266,1305,121,53,1512,224,1166,82,40
  1977 Jul,3091,440,2326,216,109,1575,231,1180,107,57,1516,209,1146,109,52
  1977 Jun,3117,454,2379,177,107,1649,245,1255,94,55,1468,209,1124,83,52
  1977 May,3073,402,2382,189,100,1561,194,1226,99,42,1512,208,1156,90,58
  1977 Apr,2961,453,2222,163,122,1564,244,1176,83,61,1396,209,1046,80,61
  1977 Mar,3108,433,2388,181,105,1652,253,1264,88,47,1455,180,1124,93,58
  1977 Feb,2672,334,2083,155,100,1371,178,1067,69,57,1301,156,1016,86,43
  1977 Jan,3206,425,2494,180,107,1618,206,1265,95,52,1588,219,1229,85,55
  1976 Dec,3775,462,3000,197,116,1922,224,1539,103,56,1853,238,1461,94,60
  1976 Nov,3749,419,2990,225,115,1952,231,1548,115,58,1797,188,1442,110,57
  1976 Oct,4156,486,3350,195,125,2150,250,1740,103,57,2006,236,1610,92,68
  1976 Sep,3954,501,3107,217,127,2043,264,1596,115,68,1909,237,1511,102,59
  1976 Aug,3728,488,2935,199,106,1964,255,1555,93,61,1764,233,1380,106,45
  1976 Jul,3579,443,2841,172,123,1822,233,1440,84,65,1757,210,1401,88,58
  1976 Jun,3349,430,2593,218,108,1692,237,1306,102,47,1657,193,1287,116,61
  1976 May,3511,477,2721,207,106,1875,274,1423,113,65,1636,203,1298,94,41
  1976 Apr,3298,469,2546,173,110,1705,248,1309,86,62,1593,221,1237,87,48
  1976 Mar,3394,439,2675,172,108,1775,221,1396,100,58,1619,218,1279,72,50
  1976 Feb,3149,420,2441,168,120,1687,223,1301,95,68,1462,197,1140,73,52
  1976 Jan,3141,436,2425,181,98,1600,215,1249,92,44,1540,221,1176,89,54
  1975 Dec,3368,456,2642,175,95,1731,225,1374,86,46,1637,231,1268,89,49
  1975 Nov,3437,438,2671,209,119,1779,219,1399,99,62,1658,219,1272,110,57
  1975 Oct,3591,491,2759,213,128,1783,250,1383,92,58,1808,241,1376,121,70
  1975 Sep,3288,466,2538,179,105,1688,232,1316,82,58,1600,234,1222,97,47
  1975 Aug,3262,445,2500,212,105,1721,231,1322,117,51,1541,214,1178,95,54
  1975 Jul,3344,490,2541,212,101,1726,252,1312,103,59,1618,238,1229,109,42
  1975 Jun,3300,484,2511,181,123,1725,273,1298,101,53,1574,211,1213,80,70
  1975 May,3399,514,2566,208,111,1769,286,1322,112,49,1630,228,1244,96,62
  1975 Apr,3415,472,2650,187,106,1802,242,1391,112,57,1613,230,1259,75,49
  1975 Mar,3412,512,2605,173,122,1758,261,1342,85,70,1654,251,1263,88,52
  1975 Feb,2951,387,2283,177,104,1508,203,1147,104,54,1443,184,1136,73,50
  1975 Jan,3181,492,2369,212,108,1637,249,1219,110,59,1544,243,1150,102,49
  1974 Dec,3451,498,2591,255,107,1796,265,1346,132,53,1655,233,1245,123,54
  1974 Nov,3421,503,2607,206,105,1778,263,1354,104,57,1643,240,1253,102,48
  1974 Oct,3958,568,3040,236,114,2027,294,1561,118,54,1931,274,1479,118,60
  1974 Sep,3855,572,2948,215,120,2004,291,1531,118,64,1851,281,1417,97,56
  1974 Aug,3778,559,2876,219,124,1968,291,1517,101,59,1810,268,1359,118,65
  1974 Jul,3694,515,2837,231,111,1964,288,1508,112,56,1730,227,1329,119,55
  1974 Jun,3632,503,2758,252,119,1883,255,1444,132,52,1749,248,1314,120,67
  1974 May,3543,501,2727,195,119,1877,254,1471,92,60,1665,247,1256,103,59
  1974 Apr,3418,532,2585,197,104,1754,268,1328,102,56,1664,264,1257,95,48
  1974 Mar,3566,501,2731,227,107,1818,274,1369,118,57,1748,227,1362,109,50
  1974 Feb,3238,429,2519,194,96,1691,212,1323,100,56,1547,217,1196,94,40
  1974 Jan,3714,495,2907,211,100,1919,262,1505,103,49,1794,233,1402,108,51
  1973 Dec,3971,542,3085,219,125,2044,302,1575,111,56,1927,240,1510,108,69
  1973 Nov,4015,509,3144,256,106,2063,265,1611,126,61,1952,244,1533,130,45
  1973 Oct,4445,620,3446,262,117,2269,329,1749,134,57,2176,291,1697,128,60
  1973 Sep,4162,595,3210,241,116,2131,293,1666,122,50,2031,302,1544,119,66
  1973 Aug,4183,592,3233,246,112,2150,297,1660,132,61,2033,295,1573,114,51
  1973 Jul,4165,591,3222,252,100,2146,300,1663,127,56,2019,291,1559,125,44
  1973 Jun,4022,580,3113,241,87,2116,294,1654,122,46,1905,286,1459,119,41
  1973 May,3814,591,2898,227,98,1976,296,1504,123,53,1838,295,1394,104,45
  1973 Apr,3786,582,2894,226,82,1989,297,1531,117,44,1795,285,1363,109,38
  1973 Mar,3950,550,3099,216,85,2061,307,1603,103,48,1889,243,1496,113,37
  1973 Feb,3646,546,2817,190,92,1870,278,1445,104,43,1775,268,1372,86,49
  1973 Jan,4110,605,3161,246,96,2140,322,1649,121,48,1968,283,1512,125,48
  1972 Dec,4352,652,3338,268,94,2245,350,1714,131,50,2107,302,1624,137,44
  1972 Nov,4434,627,3412,281,114,2219,316,1710,129,64,2215,311,1702,152,50
  1972 Oct,4690,696,3604,275,115,2433,380,1857,134,62,2257,316,1747,141,53
  1972 Sep,4550,702,3432,294,122,2386,372,1801,144,69,2164,330,1631,150,53
  1972 Aug,4357,688,3290,272,107,2228,355,1678,130,65,2129,333,1612,142,42
  1972 Jul,4110,603,3144,275,88,2164,316,1669,134,45,1946,287,1475,141,43
  1972 Jun,4000,628,3026,264,82,1979,297,1510,129,43,2021,331,1516,135,39
  1972 May,4050,665,3066,236,83,2112,348,1610,118,36,1938,317,1456,118,47
  1972 Apr,3837,637,2894,208,98,1991,328,1504,108,51,1846,309,1390,100,47
  1972 Mar,4033,624,3055,251,103,2124,332,1621,117,54,1909,292,1434,134,49
  1972 Feb,3559,508,2751,225,75,1836,259,1421,123,33,1723,249,1330,102,42
  1972 Jan,3706,564,2785,258,99,1950,311,1459,128,52,1756,253,1326,130,47
  1971 Dec,4133,601,3158,257,117,2111,303,1610,139,59,2022,298,1548,118,58
  1971 Nov,4140,634,3140,275,91,2120,326,1611,134,49,2020,308,1529,141,42
  1971 Oct,4403,665,3351,283,104,2293,358,1724,157,54,2110,307,1627,126,50
  1971 Sep,4141,646,3102,267,126,2224,336,1665,143,80,1917,310,1437,124,46
  1971 Aug,3897,566,2990,234,107,2002,287,1555,109,51,1895,279,1435,125,56
  1971 Jul,3958,608,2989,268,93,2064,315,1551,138,60,1894,293,1438,130,33
  1971 Jun,3837,622,2873,252,90,2033,322,1521,142,48,1804,300,1352,110,42
  1971 May,3847,670,2824,268,85,1955,331,1438,137,49,1892,339,1386,131,36
  1971 Apr,3746,599,2816,248,83,1950,311,1473,134,32,1796,288,1343,114,51
  1971 Mar,3844,581,2903,260,100,1914,259,1484,132,39,1930,322,1419,128,61
  1971 Feb,3374,481,2611,214,68,1755,245,1365,109,36,1619,236,1246,105,32
  1971 Jan,3768,573,2851,264,80,1886,270,1448,133,35,1882,303,1403,131,45
  1970 Dec,4058,624,3079,239,116,2044,315,1576,95,58,2014,309,1503,144,58
  1970 Nov,4250,679,3174,290,107,2214,362,1652,147,53,2036,317,1522,143,54
  1970 Oct,4199,675,3126,286,112,2181,357,1612,162,50,2018,318,1514,124,62
  1970 Sep,4117,637,3115,273,92,2083,322,1569,153,39,2034,315,1546,120,53
  1970 Aug,4072,646,3065,282,79,2109,325,1606,143,35,1963,321,1459,139,44
  1970 Jul,3830,642,2859,230,99,2015,346,1514,103,52,1815,296,1345,127,47
  1970 Jun,3716,646,2722,258,89,1875,322,1386,123,44,1840,324,1336,135,45
  1970 May,3804,624,2824,261,95,1910,300,1423,147,40,1894,324,1401,114,55
  1970 Apr,3645,588,2743,226,88,1936,301,1466,122,47,1709,287,1277,104,41
  1970 Mar,3574,511,2713,246,104,1831,250,1405,123,53,1743,261,1308,123,51
  1970 Feb,3185,486,2409,213,76,1601,239,1225,101,36,1583,247,1184,112,40
  1970 Jan,3484,558,2581,252,93,1810,281,1350,124,55,1674,277,1231,128,38
  1969 Dec,3716,563,2771,292,90,1926,285,1434,159,48,1790,278,1337,133,42
  1969 Nov,3904,594,2958,259,93,1991,312,1489,133,57,1913,282,1469,126,36
  1969 Oct,4082,658,3042,282,100,2077,346,1540,143,48,2005,312,1502,139,52
  1969 Sep,3891,613,2924,278,75,2010,322,1491,148,49,1880,291,1433,130,26
  1969 Aug,3914,611,2901,310,92,2094,328,1546,169,51,1820,283,1355,141,41
  1969 Jul,3799,617,2829,266,87,2006,323,1504,130,49,1793,294,1325,136,38
  1969 Jun,3395,640,2418,251,85,1782,342,1263,127,50,1612,298,1155,124,35
  1969 May,3572,648,2554,292,78,1832,320,1314,149,49,1740,328,1240,143,29
  1969 Apr,3579,649,2598,259,73,1835,315,1353,134,33,1744,334,1245,125,40
  1969 Mar,3670,638,2672,282,78,1883,324,1387,135,37,1787,314,1285,147,41
  1969 Feb,3296,556,2438,227,75,1674,288,1224,120,42,1622,268,1214,107,33
  1969 Jan,3744,633,2768,277,65,1917,318,1413,145,41,1826,315,1355,132,24
  1968 Dec,3988,710,2919,277,82,1999,349,1467,143,40,1989,361,1452,134,42
  1968 Nov,3954,720,2897,257,80,1981,347,1477,118,39,1973,373,1420,139,41
  1968 Oct,4338,730,3178,327,102,2222,371,1630,172,49,2115,359,1548,155,53
  1968 Sep,4013,755,2908,272,77,2080,386,1521,135,38,1932,369,1387,137,39
  1968 Aug,4092,748,2989,276,79,2109,366,1560,142,41,1983,382,1429,134,38
  1968 Jul,3979,774,2854,264,87,1985,393,1415,137,40,1994,381,1439,127,47
  1968 Jun,3774,738,2696,265,75,1953,353,1414,149,37,1821,385,1282,116,38
  1968 May,3895,711,2814,292,78,2018,370,1473,134,41,1877,341,1341,158,37
  1968 Apr,3762,693,2732,259,78,1978,379,1420,143,36,1784,314,1312,116,42
  1968 Mar,3794,695,2736,279,84,1966,365,1409,145,47,1828,330,1327,134,37
  1968 Feb,3636,638,2640,283,75,1836,330,1324,145,37,1800,308,1316,138,38
  1968 Jan,4016,755,2885,288,88,2083,400,1492,146,45,1933,355,1393,142,43
  1967 Dec,4208,811,3005,309,83,2186,410,1581,157,38,2022,401,1424,152,45
  1967 Nov,4383,729,3251,316,87,2258,360,1676,169,53,2125,369,1575,147,34
  1967 Oct,4444,860,3169,310,105,2284,432,1633,158,61,2160,428,1536,152,44
  1967 Sep,4380,793,3187,318,82,2214,385,1620,173,36,2166,408,1567,145,46
  1967 Aug,4357,810,3112,341,94,2248,450,1564,181,53,2109,360,1548,160,41
  1967 Jul,4333,847,3084,323,79,2169,440,1543,145,41,2164,407,1541,178,38
  1967 Jun,4137,809,2922,323,83,2143,413,1521,164,45,1994,396,1401,159,38
  1967 May,4096,848,2854,317,77,2064,432,1434,159,39,2032,416,1420,158,38
  1967 Apr,4161,850,2902,329,80,2104,406,1494,168,36,2057,444,1408,161,44
  1967 Mar,4247,829,2982,352,84,2198,449,1539,157,53,2049,380,1443,195,31
  1967 Feb,3614,773,2483,304,54,1817,373,1266,153,25,1797,400,1217,151,29
  1967 Jan,4200,890,2899,324,87,2152,448,1490,170,44,2048,442,1409,154,43
  1966 Dec,4559,902,3257,317,83,2378,450,1727,159,42,2181,452,1530,158,41
  1966 Nov,4374,884,3056,352,82,2211,457,1517,193,44,2163,427,1539,159,38
  1966 Oct,4962,983,3517,368,94,2549,517,1822,168,42,2413,466,1695,200,52
  1966 Sep,4568,890,3198,378,102,2295,429,1637,178,51,2273,461,1561,200,51
  1966 Aug,4497,893,3168,362,74,2286,434,1637,180,35,2211,459,1531,182,39
  1966 Jul,4541,868,3190,393,90,2360,422,1691,196,51,2181,446,1499,197,39
  1966 Jun,4618,888,3252,389,89,2421,443,1730,205,43,2197,445,1522,184,46
  1966 May,4713,1042,3242,355,74,2430,535,1668,187,40,2283,507,1574,168,34
  1966 Apr,4384,889,3035,386,74,2279,475,1572,197,35,2105,414,1463,189,39
  1966 Mar,4693,978,3261,377,77,2369,478,1654,201,36,2324,500,1607,176,41
  1966 Feb,4140,832,2957,285,66,2128,416,1516,154,42,2012,416,1441,131,24
  1966 Jan,4631,937,3233,381,79,2380,486,1671,179,44,2250,451,1562,202,35
  1965 Dec,4683,948,3280,374,80,2367,512,1627,191,37,2315,436,1653,183,43
  1965 Nov,4797,961,3370,378,87,2392,468,1696,182,46,2404,493,1674,196,41
  1965 Oct,5093,1048,3589,382,74,2632,535,1871,187,39,2461,513,1718,195,35
  1965 Sep,4848,873,3527,351,97,2487,441,1828,175,43,2361,432,1699,176,54
  1965 Aug,4739,916,3377,377,69,2433,460,1739,196,38,2306,456,1638,181,31
  1965 Jul,4781,929,3384,375,93,2491,475,1772,197,47,2290,454,1612,178,46
  1965 Jun,4430,883,3113,363,71,2271,460,1573,197,41,2159,423,1540,166,30
  1965 May,4705,957,3257,396,95,2437,466,1709,213,49,2268,491,1548,183,46
  1965 Apr,4439,855,3126,370,88,2274,425,1617,182,50,2165,430,1509,188,38
  1965 Mar,4563,893,3239,343,88,2290,426,1640,175,49,2273,467,1599,168,39
  1965 Feb,4028,789,2842,335,62,2085,396,1487,174,28,1943,393,1355,161,34
  1965 Jan,4619,956,3233,361,69,2373,497,1653,183,40,2246,459,1580,178,29
  1964 Dec,4785,989,3348,365,83,2439,502,1717,179,41,2346,487,1631,186,42
  1964 Nov,5131,995,3662,382,92,2630,524,1883,185,38,2501,471,1779,197,54
  1964 Oct,5073,977,3643,371,82,2625,485,1903,196,41,2448,492,1740,175,41
  1964 Sep,4881,932,3465,387,97,2493,471,1793,180,49,2388,461,1672,207,48
  1964 Aug,4913,957,3482,399,75,2565,488,1841,195,41,2348,469,1641,204,34
  1964 Jul,4767,1030,3316,344,77,2481,543,1720,177,41,2286,487,1596,167,36
  1964 Jun,4746,925,3311,418,92,2390,453,1662,222,53,2356,472,1649,196,39
  1964 May,4839,1029,3352,370,88,2482,501,1746,191,44,2357,528,1606,179,44
  1964 Apr,4756,972,3323,383,78,2417,518,1682,179,38,2339,454,1641,204,40
  1964 Mar,4908,973,3465,396,74,2501,489,1773,202,37,2407,484,1692,194,37
  1964 Feb,4448,909,3088,366,85,2295,463,1604,182,46,2153,446,1484,184,39
  1964 Jan,4970,1021,3482,391,76,2541,518,1790,193,40,2429,503,1692,198,36
  1963 Dec,5019,1012,3517,386,104,2551,517,1777,211,46,2468,495,1740,175,58
  1963 Nov,5318,1059,3735,416,108,2683,534,1883,220,46,2635,525,1852,196,62
  1963 Oct,5761,1078,4151,435,97,2955,602,2076,226,51,2806,476,2075,209,46
  1963 Sep,5049,982,3593,382,92,2614,518,1838,201,57,2435,464,1755,181,35
  1963 Aug,5039,963,3587,389,100,2596,477,1877,187,55,2443,486,1710,202,45
  1963 Jul,4948,958,3493,400,97,2555,498,1813,190,54,2393,460,1680,210,43
  1963 Jun,4929,995,3470,376,88,2551,514,1801,187,49,2378,481,1669,189,39
  1963 May,4966,973,3518,375,99,2525,504,1774,189,58,2440,469,1744,186,41
  1963 Apr,4836,908,3479,371,78,2456,470,1773,175,38,2380,438,1706,196,40
  1963 Mar,4687,878,3375,346,88,2419,457,1740,172,50,2268,421,1635,174,38
  1963 Feb,4165,794,2922,353,96,2148,414,1519,175,40,2017,380,1403,178,56
  1963 Jan,4813,968,3374,385,86,2483,491,1748,199,45,2330,477,1626,186,41
  1962 Dec,4927,1000,3464,371,92,2500,503,1776,179,42,2427,497,1688,192,50
  1962 Nov,5327,984,3855,381,106,2775,490,2022,201,62,2551,494,1833,180,44
  1962 Oct,5231,961,3754,402,114,2719,517,1952,191,59,2512,444,1802,211,55
  1962 Sep,5129,991,3623,406,109,2611,486,1861,200,64,2518,505,1762,206,45
  1962 Aug,4921,926,3529,380,86,2513,489,1787,196,41,2408,437,1742,184,45
  1962 Jul,4906,929,3443,421,113,2517,488,1751,211,67,2389,441,1692,210,46
  1962 Jun,4769,870,3439,370,90,2444,439,1770,186,49,2325,431,1669,184,41
  1962 May,4957,917,3545,404,91,2584,482,1827,229,46,2373,435,1718,175,45
  1962 Apr,4812,990,3367,371,84,2495,514,1757,184,40,2317,476,1610,187,44
  1962 Mar,4814,907,3426,396,85,2522,489,1768,215,50,2292,418,1658,181,35
  1962 Feb,4300,871,2992,359,78,2190,416,1553,186,35,2110,455,1439,173,43
  1962 Jan,4884,911,3496,388,89,2517,460,1807,198,52,2367,451,1689,190,37
  1961 Dec,5032,932,3626,400,74,2551,506,1808,204,33,2481,426,1818,196,41
  1961 Nov,5312,950,3913,354,94,2683,462,2007,168,46,2628,488,1906,186,48
  1961 Oct,5247,953,3775,419,100,2682,483,1937,209,53,2565,470,1838,210,47
  1961 Sep,5002,929,3534,411,128,2552,484,1816,201,51,2450,445,1718,210,77
  1961 Aug,5138,966,3703,390,79,2681,520,1920,192,49,2457,446,1783,198,30
  1961 Jul,5045,918,3635,398,94,2615,481,1913,182,39,2430,437,1722,216,55
  1961 Jun,4960,871,3600,393,96,2550,471,1851,180,48,2410,400,1749,213,48
  1961 May,4972,905,3574,393,100,2548,460,1840,199,49,2424,445,1734,194,51
  1961 Apr,4820,923,3423,383,91,2495,455,1781,207,52,2325,468,1642,176,39
  1961 Mar,4928,903,3529,406,90,2550,473,1833,198,46,2378,430,1696,208,44
  1961 Feb,4452,809,3163,411,69,2307,425,1651,198,33,2145,384,1512,213,36
  1961 Jan,5022,931,3584,401,106,2577,473,1850,203,51,2445,458,1734,198,55
  1960 Dec,5301,949,3820,440,92,2733,507,1949,228,49,2568,442,1871,212,43
  1960 Nov,5226,850,3845,440,91,2718,433,2021,214,50,2508,417,1824,226,41
  1960 Oct,5752,975,4210,455,112,2998,501,2197,237,63,2754,474,2013,218,49
  1960 Sep,5183,894,3740,452,97,2705,453,1986,209,57,2478,441,1754,243,40
  1960 Aug,5331,933,3855,441,102,2748,461,1999,241,47,2583,472,1856,200,55
  1960 Jul,5115,846,3738,423,108,2568,420,1890,205,53,2547,426,1848,218,55
  1960 Jun,5178,892,3760,449,77,2727,479,1966,239,43,2451,413,1794,210,34
  1960 May,5244,872,3868,392,112,2658,440,1958,196,64,2586,432,1910,196,48
  1960 Apr,4904,843,3610,364,87,2516,450,1834,185,47,2388,393,1776,179,40
  1960 Mar,4964,849,3639,384,92,2568,431,1883,206,48,2396,418,1756,178,44
  1960 Feb,4596,836,3290,377,93,2430,434,1767,185,44,2166,402,1523,192,49
  1960 Jan,4981,838,3589,467,87,2621,444,1888,240,49,2360,394,1701,227,38
